1,1,1,1,1,1,1,1,1,1,1,1,1,1,1,1,1,1,1,1,1,1,1,1,1,1,1,1,1,1,1,1,1,1,1,1,1,1,1,1,1,1,1,1,1,1,1,1,1,1,1,1
1,0,0,0,0,0,0,0,0,0,0,0,0,0,0,1,0,0,0,0,0,0,0,0,0,0,0,0,0,0,0,0,0,0,0,0,0,0,1,0,0,0,0,0,0,3,3,3,1,1,1,1
1,6,0,0,0,0,0,0,0,0,0,0,0,0,0,1,3,3,0,0,0,0,0,0,0,0,0,0,0,0,3,3,3,0,0,0,0,0,0,0,1,0,0,0,0,0,3,3,3,1,1,1
1,1,1,1,1,1,1,1,1,1,1,1,0,0,0,1,3,3,0,0,0,3,3,3,3,0,0,0,0,1,0,0,0,0,0,0,0,0,0,0,9,1,0,0,0,0,0,1,1,1,1,1
1,0,0,3,3,3,0,1,1,1,1,1,0,0,0,0,0,0,0,0,1,0,3,3,0,0,0,0,1,4,4,4,1,0,0,0,0,1,1,1,1,1,0,0,0,0,0,0,0,0,1,1
1,0,0,3,3,3,7,1,1,3,3,1,4,4,4,1,1,1,1,1,1,0,0,0,0,1,1,1,1,1,1,1,1,1,1,0,0,0,0,0,0,0,0,0,0,0,0,4,4,4,1,1
1,0,0,1,1,1,1,1,1,3,3,1,1,1,1,1,1,1,1,1,1,4,4,4,4,1,1,1,1,1,1,1,1,1,1,0,0,0,0,0,0,0,0,0,0,0,0,0,3,0,0,1
1,0,0,0,0,0,0,3,3,0,0,1,1,1,1,1,1,1,1,1,1,1,1,1,1,1,1,1,1,1,1,1,1,1,0,0,0,0,0,0,0,0,0,0,0,0,0,3,0,0,1,1
1,0,0,0,0,0,3,0,0,0,0,0,0,0,0,0,0,0,0,0,0,0,0,0,0,0,0,0,0,0,0,0,0,1,1,0,0,0,0,0,0,0,0,0,0,0,0,4,4,4,1,1
1,0,0,0,0,0,3,0,0,0,0,0,0,0,0,0,0,0,0,0,0,0,0,0,3,0,0,0,0,0,0,0,0,1,1,1,0,0,0,0,0,1,5,5,0,0,0,1,1,1,1,1
1,0,0,0,0,0,3,0,0,0,0,0,0,0,0,0,0,0,0,0,0,0,0,0,1,0,3,0,0,0,0,0,0,0,1,1,1,1,1,1,1,1,1,1,0,0,0,1,3,3,1,1
1,0,0,0,0,3,0,0,0,5,5,0,1,1,1,1,1,0,3,3,0,0,0,0,0,0,0,0,0,1,0,0,3,0,0,0,0,0,0,0,0,0,0,1,0,0,0,1,3,3,1,1
1,0,0,3,3,0,0,0,0,1,1,0,0,0,0,0,0,0,1,1,0,0,0,0,0,0,0,0,0,0,0,3,0,0,0,0,0,0,0,0,0,0,1,0,0,0,1,1,1,1,1,1
1,0,0,0,0,0,0,0,0,0,0,0,0,0,0,0,0,0,0,0,0,0,0,0,0,0,0,0,0,0,0,3,0,0,0,0,0,3,3,3,3,3,3,1,0,0,0,0,0,0,1,1
1,1,1,0,0,0,0,0,0,0,0,0,0,0,0,0,0,0,0,0,0,0,0,0,0,0,0,0,0,0,0,3,0,0,0,0,0,3,3,3,3,3,3,1,5,0,0,0,0,0,1,1
1,0,0,0,0,0,0,0,0,0,0,0,0,0,0,0,0,0,0,0,0,0,0,0,0,0,0,0,0,0,0,0,0,0,0,0,3,3,3,3,3,9,1,1,1,1,1,1,3,3,1,1
1,0,0,0,0,3,3,0,0,0,1,1,1,3,3,1,3,3,1,3,3,1,3,3,1,3,3,1,3,3,1,1,5,1,1,1,1,1,1,1,1,1,1,1,1,0,0,0,1,3,3,1
1,3,3,1,1,1,0,0,0,0,0,0,0,0,0,0,0,3,3,0,0,0,0,3,3,3,3,0,0,0,0,3,3,3,3,0,0,0,3,3,3,0,0,1,1,1,1,1,1,3,3,1
1,3,3,1,0,3,3,3,0,0,0,0,0,0,0,0,3,3,0,0,0,0,0,0,3,3,0,0,0,0,0,3,3,3,3,0,0,0,3,3,3,0,0,1,1,1,1,1,1,3,3,1
1,0,0,1,0,3,3,3,0,0,0,0,0,0,0,0,3,3,0,0,0,0,0,0,3,3,0,0,0,0,0,3,3,3,3,0,0,0,3,3,3,0,0,1,1,1,1,1,1,3,3,1
1,0,0,1,0,3,3,3,0,0,0,0,0,0,0,0,3,3,0,0,0,0,0,0,3,3,0,0,0,0,0,3,3,3,3,0,0,0,3,3,3,0,0,1,1,1,1,1,1,3,3,1
1,0,0,1,1,1,1,1,1,1,1,1,0,0,0,0,3,3,0,0,0,0,0,0,3,3,0,0,0,0,0,3,3,3,3,0,0,0,3,3,3,0,0,1,1,1,1,1,1,3,3,1
1,0,0,0,0,0,0,0,0,0,0,0,0,0,0,0,3,3,0,0,0,0,0,0,3,3,0,0,0,0,0,3,3,3,3,0,0,0,3,3,3,0,0,1,1,1,1,1,1,3,3,1
1,0,0,0,0,3,0,0,0,3,0,0,0,0,0,0,3,3,0,0,0,0,0,0,3,3,0,0,0,0,0,3,3,3,3,0,0,0,3,3,3,0,0,1,1,1,1,1,1,3,3,1
1,0,0,0,0,1,0,3,0,1,0,0,0,0,0,0,3,3,0,0,0,0,0,0,3,3,0,0,0,0,0,3,3,3,3,0,0,0,3,3,3,0,0,1,1,1,1,1,1,3,3,1
1,5,5,4,4,4,4,1,4,4,4,4,4,4,4,4,5,5,4,4,4,4,4,4,5,5,4,4,4,4,4,5,5,4,4,4,4,4,5,5,4,4,1,1,1,1,1,1,5,5,1,1
1,1,1,1,1,1,1,1,1,1,1,1,1,1,1,1,1,1,1,1,1,1,1,1,1,1,1,1,1,1,1,1,1,1,1,1,1,1,1,1,1,1,1,1,1,1,1,1,1,1,1,1
